mười==10==x
một trăm==100==c
mười hai==12==xii==một tá
mười sáu==16==xvi
ba mươi==ba chục==30
năm mươi==50
ace==hole-in-one==điểm một
lành==vô trùng==vô khuẩn==tiệt trùng==khử trùng==thanh trùng==tiệt khuẩn==diệt khuẩn==khử khuẩn==vệ sinh==an toàn==trong lành
họ hàng==anh em==dòng họ==dòng tộc==bà con==thông gia==anh em họ hàng==họ hàng thân thích
bố==cha==ba==thầy==tía==thân phụ==phụ thân==ông bô==ông già
chia==phân==phân chia==chia lô==chia khoảnh==chia phần==phân lô==phân khoảnh==phân phần==phân chia lô==phân chia khoảnh==phân chia phần
ban ngày==hoạt động vào ban ngày]
ban đêm==hoạt động về đêm==hoạt động ban đêm
còn phôi thai==còn trứng nước==trong phôi thai==còn trong phôi thai==còn ươm mầm==còn ở dạng phôi thai==dạng phôi thai==đang ấp ủ==còn trong ấp ủ==tiền đề==ban đầu
rào==quây==vây==bao==rào quanh==quây quanh==vây quanh==bao quanh==rào kín==quây kín==vây kín==bao kín
thiên vị==ô dù==dung túng==tây vị==thiên tư==bao che
gồm cả==gộp==gộp cả==bao gộp==kể cả==bao hàm==bao gồm==tất cả==trọn gói==tính cả
cao==ngất==cao ngất==sừng sững==lừng lững==cao ngất trời
truyền==truyền bá==quảng bá==triển khai==mở rộng==phát triển==phổ biến==truyền đi==lan đi
bào chữa==biện hộ==biện minh==chứng minh==minh chứng==chứng thực==đảm bảo==bảo chứng
cất vào gara==cất==trữ==giữ==tích==giấu==chứa==cất chứa==tàng trữ==cất giấu==tích trữ==cất trữ==cất giữ==lưu trữ==lưu giữ
đào thoát==tẩu thoát==phắn==cao chạy xa bay==lặn mất tăm==mất tăm==mất hút==đào tẩu==đào thoát==biến==chạy re kèn==ù té chạy==ù té==lủi mất==lủi một mạch==chạy biến==chuồn thẳng==chuồn đi==chuồn mất==chạy mất
biến động==biến cố==đầy biến động==đầy biến cố==nhiều biến cố==nhiều biến động
biển==biển hiệu==biển hiệu đường phố==biển tên đường==biển tên phố
bảng biểu==bảng==biểu==bảng kê==biểu kê==bảng thống kê==bảng dữ liệu==biểu thống kê==biểu dữ liệu
gợi ý==gợi==gợi mở==gợi ra==gợi thấy==gợi cho biết==tỏ ra==thể hiện==biểu hiện==biểu lộ==bộc lộ==hé mở==hé ra==mở ra
tượng trưng==biểu tượng==biểu trưng==có nghĩa==mang nghĩa
trình bày==bày tỏ==diễn đạt==phát biểu==biểu thị==biểu đạt==bộc bạch==nói lên==lên tiếng về
đồ thị==sơ đồ==biểu đồ==sơ đồ biểu diễn
bào chữa==biện hộ==biện minh==chứng minh==minh chứng==chứng thực==đảm bảo==bảo chứng
lối==nếp==thói==tục==lề thói==phong tục==tập quán==tập tục==văn hoá
rộp==rộp da==bong sơn==bong từng mảng==bong==bong ra==tróc ra==tróc từng mảng==tróc ra từng mảng
rầu==sầu==buồn==u ám==u buồn==rầu rĩ==nhàm chán==ủ dột==âu sầu==ủ ê==buồn bã==buồn thiu==ảm đạm
ngu==dốt==tối==vô minh==tối tăm==tăm tối==ngu muội==ngu xi==mu muội==sự vô minh==sự tối tăm==sự tăm tối==sự ngu muội==sự ngu xi==sự mu muội
vồ==chộp==bắt==chụp==tóm==túm==vồ lấy==chộp lấy==bắt lấy==chụp lấy==chộp lấy==tóm lấy==túm lấy
ôi==thiu==hư==hỏng==thối==xấu==mọt==mục==ôi thiu==ôi thối==thối rữa
bà==bà già==bà lão==bà cụ==cụ bà
bài==tú==lơ khơ==bộ bài==bộ tú==bộ lơ khơ==bộ tú lơ khơ==bộ bài lơ khơ==cỗ bài
lời dạy==lời răn==điều răn==huấn lệnh==lời giáo huấn==bài học
thi viết==bài thi viết==bài thi
lập==tạo==làm==tạo lập==đặt==nghĩ==sáng chế==phát minh==lập ra==tạo ra==làm ra==tạo lập ra==đặt ra==nghĩ ra==sáng chế ra==phát minh ra
bài tập==bài luyện
bài văn==bài viết==bài báo
đàm luận==đàm đạo==mạn đàm==nói về==bàn về==bàn==bàn bạc
bày==trưng bày==triển lãm==trưng bầy
đuổi==loại==tống khứ==đuổi đi==đuổi khỏi==loại trừ==loại bỏ==gạt bỏ==tống ra==loại ra==tống khỏi==đuổi tống ra==đuổi cổ khỏi
đứng==dựa==theo==đứng trên==dựa trên==dựa vào==dựa theo==theo như==bám sát==giữ vững
đi chợ==chợ búa==mua bán==mua sắm==sắm sửa==việc mua sắm==việc đi chợ==việc mua bán==việc sắm sửa
bán hàng==người bán hàng==nhân viên thị trường==người buôn bán==dân buôn
thông báo==gửi thông báo==gửi thông điệp==gởi thông báo==gởi thông điệp==chuyển thông báo==chuyển thông điệp==gửi thông báo đến==gửi thông báo cho==gửi thông điệp cho
báo cáo==bản báo cáo==báo cáo nghiên cứu==bản báo cáo nghiên cứu
cạnh==gần==sát==bên==liền==kế==kề==bên==gần kề==kế cận==cận kề==kế bên==kế liền==sát cạnh==sát bên==cạnh bên==bên cạnh==sát ngay==tiệm cận
dưới==ở dưới==bên dưới==phía dưới==ở bên dưới==ở phía dưới
còn==còn lại==có==còn có==vẫn còn==vẫn có
xa==xa xôi==xa vời==xa xăm==xa cách==xa tít==xa tắp==xa tít tắp==xa tít xa tắp==xa lắc==xa lắc lơ==xa lắc xa lơ
bêu==bêu xấu==bêu rếu==lăng mạ==lên án==chỉ trích==lăng nhục==nhục mạ==thoá mạ
nghèo==ít==nhỏ==thiếu thốn==ít ỏi==sơ sài==nghèo nàn==eo hẹp
nhàn==nhàn nhã==nhàn rỗi==thư thả==thong thả==bình tĩnh==bình chân==bình chân như vại==không vội==không vội vàng==không vội vã==không gấp gáp
cách==mẹo==cách thức==phương pháp==bí quyết==phương thức
tra dầu mỡ==bôi trơn
giải==đọc==dịch==tìm==giải mã==đọc mã==dịch mã==tìm mã==giải mật mã==đọc mật mã==dịch mật mã==tìm mật mã
bưu điện==bưu chính
ước==áng==đoán==chừng==ước lượng==ước chừng==ước tính==xấp xỉ==áng chừng==đoán chừng==khoảng==độ==đánh giá
nối==kết==gắn==thông==kết nối==nối kết==gắn kết==nối liền==nối lại==gắn lại==rút ngắn==nối kết lại==kết nối lại==gắn kết lại
phá==phá hại==phá hỏng==tàn phá==phá huỷ==phá hoại==làm hư==làm hại==làm hỏng==làm rối==đánh rối==làm rối tung==làm lộn xộn==làm xáo trộn
ngăn==chặn==cản==trấn áp==khuất phục==khống chế==chế ngự==áp chế==đàn áp==áp đảo==ngăn chặn==ngăn cản==cấm cản
bạn==tri kỉ==bằng hữu==hảo hữu==bạn bè==bạn bè bằng hữu==tri âm tri kỉ==tri kỷ==tri âm tri kỷ
làng==xã==thôn==bản
trong==quang==quang đãng==trong trẻo==trong sáng
mẫu mực==hình mẫu==mẫu==mẫu gương==kiểu mẫu==bản mẫu
bản thân==tự thân==đích thân==tự tay==đích tay
bản thảo==bản dự thảo==bản phác thảo
tin==cậy==nhờ==tin cậy==trông cậy==nhờ cậy==tin tưởng==uỷ thác==phó thác==giao phó
dạy==chỉ bảo==hướng dẫn==dạy cho==truyền dạy cho==huấn luyện==giảng dạy==dạy dỗ==dạy học==dạy bảo
thấy==cảm thấy==co cảm giác==có cảm tưởng==trải qua==kinh qua==nếm mùi==chịu đựng
vững==ổn==bền==chắc==ổn định==bền vững==vững vàng==bình ổn==vững chắc==bền chắc
sửa==sửa chữa==cải chính==đính chính==hiệu chỉnh==sự sửa==sự sửa chữa==sự cải chính==sự đính chính==sự hiệu chỉnh
cắt==gọt==đẽo==xén==tỉa==cắt gọt==cắt tỉa==cắt xén==gọt đẽo==đẽo gọt
bất cứ==bất kì==bất kể
bất hợp tác==không được hợp tác==không được phối hợp
ngăn==cản==ngừng==dừng==cấm==đình==ngăn cản==ngăn chặn==ngăn cấm==cản phá==đình chỉ==cấm cản==dừng lại==ngừng lại
bất lực==bất khả==bất khả kháng==bất khả thi==vô hiệu==không vượt qua được==không thể khắc phục
căm==uất==phẫn==oán==căm thù==căm hờn==căm tức==căm giận==căm phẫn==phẫn nộ==uất ức==uất hận==oán hận==oán giận==ai oán
kinh dị==lạ lùng==ngạc nhiên==kinh ngạc==bất ngờ==đáng ngạc nhiên==đáng kinh ngạc==đầy bất ngờ
khó khăn==rối beng==rối mù==rối tung==bồi hồi==bứt rứt==bất ổn==rối loạn==rắc rối==phiền phức==không yên==hỗn loạn
đối lập==đối kháng==tương phản==đối chọi==đối nghịch==sự đối lập==sự đối kháng==sự tương phản==sự đối chọi==sự đối nghịch==quan hệ đối lập==quan hệ đối kháng==quan hệ tương phản==quan hệ đối chọi==quan hệ đối nghịch
thời đó==thời ấy==bấy giờ==ở thời đó==ở thời ấy
chửa==bầu==mang thai==mang bầu==có thai==có mang==có chửa==có bầu==bầu bí
bận==bận rộn==bận bịu==nhiều việc
bắc==hướng bắc==chính bắc==hướng chính bắc==N==hướng N
buộc==trói==cột==buộc vào==trói vào==cột vào==buộc vào cọc==trói vào cọc==cột vào cọc
bắt chuyện==bắt chuyện với==nói với==nói chuyện với
nắm bắt==am hiểu==hiểu biết==sự nắm bắt==độ am hiểu==độ hiểu biết==mức độ hiểu biết
bắt đầu==khởi sự==khởi hành==khởi động==mở màn==mào đầu==khởi sự==khởi xướng==phát đoan==khai đoan
ương==ngang==bướng==ương ngạnh==ương bướng==ngang ngạnh==bướng bỉnh==ngoan cố==cố chấp==cứng đầu==khó bảo==khó nói==khó dạy
vững==ổn==bền==chắc==ổn định==bền vững==vững vàng==bình ổn==vững chắc==bền chắc
bị động==thụ động==thiếu chủ động==thiếu tích cực==không chủ động==không tích cực
bọn==nhóm==tụi==cánh==lũ==đám==nhóm bạn==bọn bạn==tụi bạn==đám bạn==đám bạn==cánh bạn
xoá==bỏ==diệt==khử==gạch bỏ==xoá bỏ==bỏ đi==tiêu diệt==phá huỷ==huỷ bỏ==tiêu trừ==trừ bỏ==trừ khử
mở==tháo==cởi==nới==gỡ==tháo ra==cởi ra==gỡ ra==cởi bỏ==tháo bỏ
bơ==lơ==lờ==phớt==phớt lờ==bơ đi==lơ đi==lờ đi==bỏ bẵng==bỏ ngoài tai
để lại==bỏ lại==bỏ quên==rời bỏ==vứt lại
bố cục==cơ cấu==hệ thống==cách sắp xếp
bố trí==cắt cử==điều người==cấp người==cử người vào==điều người vào==bố trí người==bố trí nhân lực
bối rối==lo âu==âu lo==gây bối rối==làm lo âu==làm náo động==làm xáo trộn==làm náo động==làm mất yên tĩnh
thứ tư==thứ bốn==số bốn==bốn==bậc tư==bậc bốn==cấp bốn==hạng thứ tư==vị trí thứ tư
nâng cao==bồi dưỡng==giáo dục==đào tạo==rèn luyện==huấn luyện
vỡ==tan==nát==gãy==gẫy==đứt==bửa==tan rã==bửa ra==vỡ ra==bị vỡ==bị vỡ ra==bị gãy==bị gãy ra==bị đứt==bị đứt ra==bị đập vỡ
lập==tạo==tạo lập==thành lập==lập nên==lập ra==tạo dựng==tạo nên==tạo ra==hình thành nên
ngoại tình==gian dâm==thông dâm==phản bội==cắm sừng==phụ bạc==lừa dối==phụ tình==phụ
giúp==giúp ích==có ích==giúp đỡ==cứu đỡ==cứu giúp==hỗ trợ==cứu trợ==viện trợ==cứu viện
chuỗi==dãy==loạt==mạch==dòng==đoàn==xâu
qui định==quy định==qui chế==quy chế==qui tắc==quy tắc==theo qui định==theo quy định==theo qui chế==theo quy chế==theo qui tắc==theo quy tắc
tỉ mỉ==tỷ mỉ==kĩ==kĩ càng==kĩ lưỡng==kỹ==kỹ lưỡng==chi tiết==cặn kẽ==từng li từng tí==quá kĩ càng
ngây thơ==thơ ngay==trong sáng==hồn nhiên==chất phác==chân thật==chân chất==không khôn ngoan==không xảo quyệt==không gian giảo==không gian trá==không gian xảo==không giảo hoạt==không giảo quyệt==không man trá==không quỉ quyệt==không quỷ quyệt==không xảo trá
giảm==bớt==hạ==giảm bớt==hạ bớt==làm giảm==làm bớt==làm hạ==làm hạ bớt==làm giảm bớt
vỡ==bể==gãy==gẫy==đứt==vỡ ra==bể ra==gãy ra==gẫy ra==đứt ra==gãy rời==gãy rời ra
hát==ca==xướng==xướng ca==diễn xướng==ca hát
kìm==hãm==nén==kìm nén==kìm hãm==chứa chấp==ấp ủ==nuôi dưỡng==kìm lại==hãm lại==nén lại==kìm nén lại==kìm hãm lại
đứng đầu==chỉ huy==phụ trách==lãnh đạo==cầm đầu==dẫn đường==cầm lái==chỉ đạo==dẫn lối
kiểu người==loại người==thứ==đồ==giống==hạng==nhà
liều==liều lĩnh==táo bạo==táo tợn==dũng cảm==táo bạo==anh dũng==gan dạ==can đảm==gan góc==cả gan
cô==canh==chưng==cô đặc==tinh luyện==tinh lọc==tinh chế
cao==cao lớn==dỏng==dong dỏng cao
dở==dở dang==dang dở==dở chừng====bỏ dở==chưa xong==chưa hoàn thiện==chưa hoàn thành==chưa kết thúc
tụ==hợp==tụm==tụ tập==quần tụ==quy tụ==tập hợp==túm tụm đàn đúm==nhóm họp==tụ lại==quy lại==quy về một mối
gặp==gặp mặt==đấu==thi==thi đấu==chạm trán==đụng độ==so tài==so sức==đọ tài==đọ sức==so găng==so cao thấp==cạnh tranh==tranh giành==đấu với==thi đấu với==đối đầu với==chạm trán với==đụng độ với==chiến đấu với
trước==trước đây==trước kia==thời trước==ngày xưa==xưa kia==xưa==thuở trước
sau phổ thông==trung cấp==cao đẳng==đại học
nghiến==khép==mím==nắm==khép chặt==siết chặt==nghiến chặt==mím chặt==nắm chặt
đãi==chao==gạn
bôi==phủ==phết==dán==trát==quyết==áp==bôi lên==phết lên==dán lên
tiêu==chi==chi tiêu==tiêu pha==tiêu tiền==chi phí
chỉ==dẫn==trỏ==chỉ dẫn==chỉ đường==dẫn đường==trỏ đường==chỉ lối==dẫn lối==trỏ lối==dẫn hướng==chỉ hướng==trỏ hướng
đối==ngược==nghịch==đối lại==ngược lại==nghịch lại==đối nghịch==trái ngược==đối nhau==ngược nhau
chia sẻ==san sẻ==chia sớt==san sớt==nói cho
cướp==chiếm==đoạt==chiếm đoạt==cướp đoạt==chiếm dụng==chiếm giữ==chiếm lấy==xâm chiếm==cướp chiếm
sóng==con sóng==làn sóng==đợt sóng==dải sóng
binh lược==binh pháp==chiến lược==chiến lược quân sự
trụ==qua==vượt==vượt qua==trụ vững==trụ được==qua được==chịu được==trụ lại==trụ vững được==vượt qua được==chịu đựng được==trụ lại được
sờ==mó==rờ==đụng==động==chạm==sờ vào==mó vào==rờ vào==động vào==đụng vào==động vào==chạm vào==sờ mó==rờ mó==động chạm==đụng chạm
chiều==cưng==nuông==nuông chiều==chiều chuộng==cưng chiều==làm hư
định==vạch==nhìn==xác định==định rõ==vạch rõ==chỉ rõ==xác định rõ==định ra==vạch ra==nhìn ra
nghĩ==tưởng==tưởng tượng==hình dung==mường tượng==nghĩ được==nghĩ là==cho là==coi như
cho mượn==cho vay
gửi==gởi==gửi thư==gởi thư==gửi thư điện tử==gởi thư điện tử==gửi email==gởi mail==gửi điện thư==gửi email==gởi mail==chuyển email==chuyển mail==chuyển thư==chuyển thư điện tử
giả sử==giả định==giả thiết==cho rằng==giả như==giả thử==giả tỉ==ví thử
chu==chẩu
chú ý==để ý==lắng nghe==để tâm==chú tâm==lắng tai==thấy==nhận thấy
chua==lên men==thiu==ôi==hư==hỏng==bị chua==bị lên men==bị thiu==bị ôi==bị hư==bị hỏng
chung==được chia sẻ==được sẻ chia==được đồng cảm==được thông cảm==được cảm thông
khái quát==chung chung==tổng quát
kiên nhẫn==nhẫn nại==bền chí==kiên trì==kiên tâm==bền bỉ
chuyên gia==chuyên viên==nhà chuyên khoa
chuyên ngành==chuyên môn
nhan đề==đề mục==đầu đề==tiêu đề==dòng tít==tít
kĩ năng==kỹ năng==kĩ nghệ==kỹ nghệ==tài nghệ==chuyên nghiệp
chuyên sâu==tập trung sâu
ẩn==khuất==lẩn==được che==được đậy==được giấu giếm==được che đậy==được bưng bít==được che giấu==được chôn giấu==được cất giấu==bị lẩn khuất==bị giấu giếm==bị che đậy==bị bưng bít==bị che giấu==bị chôn giấu==bị cất giấu
thay đổi==đổi thay==biến đổi==cải biến==biến cải==hoán cải==làm thay đổi==làm biến đổi==làm cho thay đổi
việc==vụ==vụ việc==vụ kiện==vụ tố tụng==việc kiện==việc tố tụng
thật==tự nhiên==chân thật==thành thật==chân thực==thành thực==thật lòng==thực lòng==thật tâm==thực tâm
gốc==nguồn==nguồn gốc==căn nguyên==khởi nguyên==xuất xứ==nguồn cội==cội nguồn==khởi đầu==khởi thuỷ==nguyên uỷ
tiếp thị==giới thiệu==quảng cáo==quảng bá
chung cuộc==cuối==chót==rốt==cuối cùng==sau cùng==sau chót==sau rốt
trêu==chọc==ghẹo==quấy rầy==làm phiền==chọc ghẹo==trêu chọc==quấy rối==gây rối==chọc tức==chọc giận==làm phát cáu==làm phát bực==gây phiền hà==gây phiền phức==làm bực mình
vị trí==tầng lớp==địa vị==ghế==chỗ==chiếu==chỗ đứng
lệch==chênh lệch==không cân==không tương đương==không bằng==không cân bằng==không ngang bằng==không giống==không bằng nhau==không giống nhau==không ngang nhau==không ngang bằng nhau
chính==chủ yếu==cốt yếu==trung tâm==nền tảng==căn bản==cơ bản==trọng tâm
chính sách==chủ trương
lề==thói==lề thói==nghi thức==nghi tiết==thủ tục
chính trị==chính trị học==khoa học chính trị
giam==giữ==bỏ tù==tống giam==bắt giam==bắt giữ==giam cầm==giam giữ==cầm tù==giam hãm
xứng đáng==chính đáng==đúng nghĩa==hợp lẽ phải
thé==chói==the thé==chói vói==inh tai==inh tai nhức óc
chung cuộc==cuối==chót==rốt==cuối cùng==sau cùng==sau chót==sau rốt
tụ==hợp==tụm==tụ tập==quần tụ==quy tụ==tập hợp==túm tụm đàn đúm==nhóm họp==tụ lại==quy lại==quy về một mối
chú ý==để ý==lắng nghe==để tâm==chú tâm==lắng tai==thấy==nhận thấy
gục==rũ==cúi==chúc==gục xuống==rũ xuống==rũ ra==cúi xuống
khen ngợi==sự khen ngợi==ca ngợi==sự ca ngợi==tán dương==sự tán dương==lời khen ngợi==lời ca ngợi==lời tán dương
chốc==lúc==lát==chốc lát==tí==tẹo,
chằm chằm==chăm chú==nhìn chằm chằm==nhìn chăm chú
kế hoạch==chương trình==kế hoạch làm việc==chương trình nghị sự
chạy==hoạt động==sự chạy==sự hoạt động
đổ==ngã==lật==xoà==xoã==đổ vật==đổ vật ra==ngã vật==ngã vật ra
chấm==hạt cát==hạt bụi==vết li ti==vệt li ti
ngăn==chặn==cản==trấn áp==khuất phục==khống chế==chế ngự==áp chế==đàn áp==áp đảo==ngăn chặn==ngăn cản==cấm cản
đồng ý==tán thành==bằng lòng==đồng tình==tán đồng==sự đồng ý==sự tán thành==sự bằng lòng==sự đồng tình==sự tán đồng
cất vào gara==cất==trữ==giữ==tích==giấu==chứa==cất chứa==tàng trữ==cất giấu==tích trữ==cất trữ==cất giữ==lưu trữ==lưu giữ
tính==tính khí==tính tình==tính cách==tính nết==phẩm chất
chậm==chậm chạp==lề mề==dềnh dang==dềnh dàng==trễ nải==trễ tràng
nhấp nháy==chập chờn==lung linh==lấp lánh
sít==khít==chật==vừa khít==vừa sít==bó sát==bó chặt==bó khít==bó sít==khít khìn khịt==sít sìn sịt==vừa khít khìn khịt==vừa sít sìn sịt==bó sát sàn sạt
đích thực==chân chính==đích thật==thực sự==thật sự
chặn==chắn==ngăn==cản==ngăn cản==chặn lại==chắn lại==ngăn lại==cản lại==ngăn cản lại
chết==mất==đi==qua đời==hi sinh==từ trần==băng hà==viên tịch==ra đi==tắt thở==về trời==về nơi chín suối==về cõi vĩnh hằng==xuống suối vàng==an giấc ngàn thu==an giấc nghìn thu==khuất núi==tử trận==tử vong==tạ thế==trầu trời==nhắm mắt xuôi tay==thăng==tử mạng==bỏ mạng==thiệt mạng==toi==ngỏm==ngủm==nghẻo==tẻo==ngỏm củ tỏi==ngủm củ tỏi==xuống lỗ==tiêu đời
bêu==bêu xấu==bêu rếu==lăng mạ==lên án==chỉ trích==lăng nhục==nhục mạ==thoá mạ
ảnh hưởng==tác động==chạm đến==ảnh hưởng đến==ảnh hưởng tới==tác động lên==tác động tới==tác động đến==làm ảnh hưởng đến==làm ảnh hưởng tới
hợp==xứng==thích hợp==hợp lí==hợp lý==đúng mực==phải lẽ==hợp lẽ==lịch sự==đàng hoàng==đứng đắn
hàng==đầu hàng==quy hàng==chịu thua==quy phục==chịu phục==khuất phục
chọn==lựa==tuyển==nhặt==chọn lựa==lựa chọn==tuyển chọn==tuyển lựa==xét tuyển==nhặt nhạnh
đập==đập vỡ==đập tan==đập nát==đập vụn==phá tan==phá vỡ==đánh sập==kéo đổ==nổ bom==đập vỡ tan==đập vỡ tan tành==phá tan tành
nhô ra==nhú ra==lộ ra==vọt ra==hiện ra==lòi ra==xuất hiện==nổi lên
đan==lồng==cài==đan vào nhau==lồng vào nhau==cài vào nhau
kì vọng==kỳ vọng==mong đợi==chờ đợi==đợi chờ==chờ mong==hi vọng==hy vọng==sự kì vọng==sự kỳ vọng==sự mong đợi==sự chờ đợi==sự đợi chờ==sự hi vọng==sự hy vọng==sự chờ mong
thị trường==thương trường==chợ
người phụ trách==phụ trách==thủ trưởng==sếp==đầu==trưởng==chủ
chủ nhật==Sunday==Lords_Day==Dominicus==Sun
chủ quan==tính chủ quan==chủ nghĩa chủ quan
mô típ==đề tài==chủ đề
định==vạch==nhìn==xác định==định rõ==vạch rõ==chỉ rõ==xác định rõ==định ra==vạch ra==nhìn ra
chứa==đựng==chứa đựng==chứa được==đựng được
Thánh chức==chức==chức Thánh==Giáo phẩm
chức năng==nhiệm vụ==tác dụng==vai trò==công năng
chữ cái==con chữ==chữ==mẫu tự
chữ kí==chữ ký
chữ viết tay==chữ viết==tự dạng
gập==gấp==đóng==thu==gập lại==đóng lại==gập vào==đóng vào==thu vào==thu lại
xét==xem==nhìn==xem xét==suy xét==suy nghĩ==suy ngẫm==nghiền ngẫm==nhìn nhận
con==con cái==con cháu
người==mọi người==người dân==đồng bào==cộng đồng==tộc người==quần chúng==cư dân==dân chúng==thiên hạ==dân tộc==nhân dân
cỡ==kích cỡ==số==size
cong==oằn==oặt==quằn==cong queo
chép==sao==cóp==copy==sao chép==chép lại==sao lại==cóp lại==copy lại
nuôi==trồng==nuôi trồng==trồng trọt==cày cấy==cấy cày==cầy cấy==cấy cầy
gập==gấp==vén==xắn==bẻ==gập lên==gấp lên==vén lên==xắn lên==bẻ lên
cuộc họp==cuộc hội họp==cuộc gặp==cuộc gặp gỡ==sự gặp mặt==sự gặp gỡ
kiếp==cõi==cuộc đời==đời người
mài==giũa==dũa==cà==mài giũa==mài dũa
nói==khẳng định==quả quyết==cam đoan==bảo đảm==dám chắc==cá
lạ==kì==lạ thường==kì lạ==lạ kì==kì quặc==bất thường==hiếm gặp==chưa từng có==chưa từng thấy==chưa có tiền lệ
xay==nghiền==băm==tán==cắt nhỏ==thái chỉ==thái con chì
cai tù==cai ngục==quản ngục==quản tù==cán bộ==quản giáo==người cai tù==người cai ngục==viên cai tù==viên cai ngục==người quản ngục==người quản tù==viên quản ngục==viên quản tù==quản giáo trại giam==người quản lí trại giam==cán bộ quản lí trại giam
viện==vin==vịn==cáo==viện đến==viện dẫn==vin vào==vịn vào==vin đến==vịn đến
cứng==cứng nhắc==nghiêm khắc==khắt khe==ngặt==nghiêm ngặt==nghiêm nhặt==gắt==gắt gao==không linh hoạt==không linh động
do dự==lưỡng lự==phân vân==dao động==nghi ngại==nao núng==chần chờ==chần chừ==đắn đo==lần chần==lần khần==lưỡng lự==ngần ngừ==phân vân==trù trừ==không nhất quyết==không chắc chắn==không biết chắc
cãi vã==cãi lộn==cãi cọ==tranh cãi==cãi lẫy==cuộc cãi vã==cuộc cãi lộn==cuộc cãi cọ==cuộc tranh cãi==cuộc cãi lẫy
cò==trung gian==môi giới==người trung gian==người môi giới
ưa nhìn==dễ nhìn==hợp nhãn==ưa mắt==thích mắt==thuận mắt==dễ ưa==xinh==xinh xắn==xinh đẹp==có duyên
quan trọng==có ý nghĩa==có giá trị==được kể đến==được tính đến==được chú ý đến==được quan tâm đến
hất==đẩy==xô==hẩy==xô đẩy==hất ra==đẩy ra==xô ra==hẩy ra
trông==có vẻ==nom vẻ==giống như==trông giống với==trông hợp với==nom giống với==trông giống như
ẩn ý==ngụ ý==hệ quả==hàm ý==ý==ý==nghĩa==ý nghĩa
sơ qua==sơ sơ==ngắn gọn==trình bày sơ sơ==trình bày sơ qua==trình bày ngắn gọn
công bằng==công minh==công tâm==sự công bằng==sự công chính==sự công minh==sự trung trực==sự chính trực==công minh chính trực
rao==công bố==thông cáo==tuyên bố==tuyên cáo
dân==cư dân==công dân==người dân==dân bản địa==người dân bản địa==dân cư
cố gắng==phấn đấu==sự theo đuổi==sự đeo đuổi==sự cố gắng==sự phấn đấu==sự đấu tranh==sự tranh đấu==sự chiến đấu
công nghệ thông tin==khoa học thông tin==IP
công nhân==thợ==người thợ==người lao động
soát==duyệt==xác định==kiểm lại==thẩm tra==xác minh==xác nhận==soát duyệt==soát lại
nợ==công nợ==nợ nần==khoản nợ==món nợ
công ti==công ty==hãng==doanh nghiệp
công việc==công tác
hiệp hội==nghiệp đoàn công nhân==nghiệp đoàn==công đoàn
đồng thời==cùng lúc==song song==sự đồng thời==tính đồng thời==sự cùng lúc==sự song song
kết hợp==sự kết hợp==hành động kết hợp==liên kết==sự liên kết==hành động liên kết==liên hợp==sự liên hợp==hành động liên hợp
cúng==tế==tế lễ==tế thánh==dâng thánh==dâng lễ==cúng lễ==cúng tế==tế thần linh==cúng thần linh==dâng thần linh
bằng chứng==cơ sở==chứng cứ==chứng cớ==bằng cứ==bằng cớ
lỏng ra==long==giãn bớt==giãn ra==chùng ra==long ra
nguyên==nguyên vẹn==vẹn nguyên==được bảo quản==được bảo toàn==được giữ gìn==được gìn giữ==được nguyên vẹn==được vẹn nguyên==được toàn vẹn
cơ==tay==thủ công==bằng tay
mẻ==đợt==lô==ổ==lứa==lò
máy móc==cơ khí==cơ giới
tổ chức==sự tổ chức==việc tổ chức
thể xác==xác thịt==thân thể==cơ thể
cơn==rối loạn==cơn rối loạn==sự rối loạn
nụ cười==cười
gặp==gặp mặt==đấu==thi==thi đấu==chạm trán==đụng độ==so tài==so sức==đọ tài==đọ sức==so găng==so cao thấp==cạnh tranh==tranh giành==đấu với==thi đấu với==đối đầu với==chạm trán với==đụng độ với==chiến đấu với
thứ bảy==số bảy==bảy==hạng bảy==cấp bảy==bậc bảy==hạng thứ bảy==vị trí thứ bảy==thứ bẩy==số bẩy==bẩy==hạng bẩy==cấp bẩy==bậc bẩy==hạng thứ bẩy==vị trí thứ bẩy
cải thiện==giúp cải thiện==làm cải thiện
ấn tượng==cảm giác==cảm tưởng==cảm nhận==cảm nghĩ==suy nghĩ==ý kiến
cảm hứng==nguồn cảm hứng
cảm thức==cảm thụ==thụ cảm
mùi==hương==mùi hương==xạ==hơi==mùi hơi
cảnh==phong cảnh==cảnh tượng==hình ảnh
ẩu==bừa==cẩu thả==bất cẩn==ào ào==vô tâm==vội vàng==thiếu thận trọng==thiểu cẩn trọng==thiếu cẩn thận==thiếu chín chắn==thiếu suy nghĩ==thiếu xem xét==không thận trọng==không cẩn trọng==không cẩn thận==không chín chắn==không suy nghĩ==không xem xét
hàm==lon==quân hàm==phù hiệu quân hàm
hầu==cấp dưới==đầy tớ==tôi tớ==hầu cận==trợ lí==giúp việc
trao==ban==dâng==tặng==giao==trao tặng==ban tặng==dâng tặng
cấp trên==người cấp trên
kết cấu==cấu trúc==cấu tạo
cầm==cắm==thế chấp==cầm đồ==cắm đồ==thế chấp đồ==sự thế chấp==sự cầm đồ==sự cắm đồ
cần thiết==thiết yếu==thiết thực
đẫy==tròn==đẫy đà==đầy đặn==viên mãn==tròn đầy==tròn trịa==nảy nở==nở nang==mỡ màng
thận trọng==cẩn trọng==cẩn thận==khôn ngoan==khôn khéo==sáng suốt==tinh tường
cập nhật==có tính thời sự
bẻ==xé==cắt==làm gãy==làm gẫy==bẻ gãy==bẻ gẫy==làm đứt
chà==xát==cọ==cạ==chà xát==cọ xát
cố ý==cố tình==mưu tính==mưu toan==có chủ tâm
cố vấn==tham mưu
cồn==có cồn==có chất rượu
phép cộng==cộng==tổng==phép lấy tổng
hành xác==cấm dục==khắc kỉ==khổ tu==tu khổ hạnh==kìm hãm==kiềm chế
thân mật==nồng nhiệt==suồng sã==gần gũi==gần gụi==dễ gần==cởi mở==thân thiện
cỡ==size==có cỡ
vọt==bắn==phọt==phun==phụt==lao==vọt ra==bắn ra==vọt lên==phun ra==phụt ra==bắn ra==lao đi==lao vút==lao vun vút
độc==hại==độc hại==có độc==có hại==có độc hại==mang mầm bệnh==mang nguy cơ lây bệnh==mang vi-rút==có vi-rút
cụm từ==ngữ
cứ==cách mỗi==cứ cách==cứ mỗi==cứ cách mỗi
ưu tú==xuất sắc==lỗi lạc==tài giỏi==hơn người==xuất chúng==tài==có tài==có giá trị tài ba==tài giỏi==tài tình
dày dạn==dạn dày==dầy dạn==mạnh mẽ==cứng rắn
cứu==cứu vãn==cứu nguy
diện mạo==vẻ ngoài==dáng vẻ==hình dáng==bề ngoài==dáng vẻ bề ngoài==hình dáng bên ngoài
yếu==oải==nản==dặt dẹo==phờ phạc==yếu ớt==bơ phờ==mệt mỏi==uể oải
cực đoan==quá khích
đỉnh cao==đỉnh điểm==cực điểm==tột đỉnh==cực độ==tột bậc==tột bực==tột cùng==tột độ
mở rộng==phát triển==gia tăng==sự mở rộng==sự phát triển==sự gia tăng
giờ==tiếng==giờ đồng hồ==tiếng đồng hồ==sáu mươi phút==sáu chục phút==60 phút==h
danh sách==bản danh sách==bảng danh sách==danh sách dữ liệu==bản danh sách dữ liệu==bảng danh sách dữ liệu
tên gọi==danh hiệu==danh xưng
day==véo==vấu==beo==bấu==cấu==day nhẹ==day day==véo yêu
lấy==rút==lôi==kéo==nhổ==lấy ra==rút ra==kéo ra==lôi ra==nhổ ra==trích xuất==kể lể ra
dời đi==sự dời đi==di dời==sự di dời==di chuyển==sự di chuyển
vận động==chuyển động==di động==sự vận động==sự chuyển động==sự di động
diềm==rìa==mép==bên rìa==bên mép
gượng==kịch==diễn==gượng gạo==giả vờ==không thật==không tự nhiên
giải nghĩa==cắt nghĩa==giảng nghĩa==giải thích==làm rõ==làm sáng tỏ==làm sáng rõ
thuyết trình==diễn thuyết==hùng biện==sự thuyết trình==sự diễn thuyết
sơn==tô==vẽ==sơn màu==tô màu==vẽ màu
diễn văn==bài diễn văn==bài diễn thuyết==bài thuyết trình
thương gia==doanh nhân==nhà kinh doanh==nhà buôn==thương nhân==doanh gia
du lịch==du ngoạn==du hoành==du kí==du lãm==du nhai==du ngoại==chu du==vãn du==viễn du
cùng==đồng==trùng==cùng màu==đồng màu==trùng màu==cùng mầu==đồng mầu==trùng mầu
dài==dài ra==dãn ra==kéo dài==dãn dài==được kéo dài==được căng dài==được dãn dài
duyệt==phê duyệt==thông qua==chuẩn qua
vô biên==vô cực==vô cùng==vô tận==vô hạn==vô kể==khôn cùng==khôn xiết==không hết==không xuể==khôn kể xiết==không bờ bến==không bến bờ==không điểm dừng==không giới hạn
dài dòng==dông dài==rườm rà==vòng vèo==nhiều lời==dài dòng văn tự
dàn ý==dàn bài==sườn==đặc điểm chính==đề cương
gửi==gởi==giao==giao phó==uỷ thác==kí thác==ký thác==gửi gắm==gởi gắm
đặc==đặc quánh==đặc sệt==đặc lại==đặc quánh lại==đặc sệt lại
coi khinh==coi thường==xem khinh==cự tuyệt==xúc phạm==sự coi khinh==sự coi thường==sự khinh thường==sự khinh miệt==sự coi rẻ
gắn chặt==dán==dán mắt==dán chặt==đóng chặt==gắn chắc==cài chắc==thắt chặt==buộc chặt==kháo chặt
dân sự==thường dân==thuộc về thường dân
dân tộc==quốc gia
vướng==mắc==xen==vướng vào==dính vào==vướng phải==mắc phải==xen với==liên quan==liên quan tới
dạng==hình thức==mô hình
giẫm==dẫm==đạp==dận==giẫm xuống==giẫm vào==dẫm xuống==dẫm vào==dận xuống
dấu==vết==dấu vết==bóng dáng==dấu hiệu==dáu tích==vết tích
đánh==quất==quật==đánh đòn==đánh đập==trận đòn==sự đánh đòn==sự đánh đập==trận đòn đau==trận đánh đòn==trận đòn đánh
dẫn chương trình==làm MC==giới thiệu chương trình
đưa ví dụ==cho ví dụ==lấy ví dụ==dẫn chứng==dẫn ra
dậy==thức dậy==trở dậy==thức giấc==tỉnh giấc==bình minh==ngủ dậy
êm==mượt==ngon==nuột==uyển chuyển==dễ dàng==mềm mại
dễ hiểu==lí giải được==giải thích được==có thể lí giải==có thể giải thích==có thể lí giải được==có thể giải thích được
dịu dàng==nữa tính==thuỳ mị==thuỳ mỵ==uỷ mị==uỷ mỵ
dốc==đổ hết==đổ ra==trút sạch==làm cạn==tháo sạch==trút hết ra==đổ ra sạch
vắt==nặn==miết==dồn==dí
dở==dở dang==dang dở==dở chừng==chưa xong==chưa hoàn thiện==chưa hoàn thành
nhử==dử==dụ==mời==chào mời==mời chào==mời mọc==cám dỗ==quyến rũ==lôi cuốn==thu hút==dụ dỗ==lôi kéo==rủ rê==làm thèm==gợi thèm
phương tiện==công cụ==phương tiện truyền thông==công cụ truyền thông
dữ liệu==tài liệu==tập dữ liệu==hồ sơ
đoán==dự==ước đoán==dự đoán==tiên đoán==đoán trước==sự đoán==sự ước đoán==sự dự đoán==sự tiên đoán==sự đoán trước
đề ra==bày mưu==lập mưu==tính kế==bày mưu tính kế==lên kế hoạch==đặt kế hoạch==vạch kế hoạch==lập kế hoạch
nhát==rụt rè==nhút nhát==dút dát==rút rát==bẽn lẽn==e lệ==e dè
anh em họ==anh chị em họ==chị em họ==anh họ==chị họ==em họ
anh trai==em trai==anh ruột==anh trai ruột==em trai ruột
thư điện tử==e-mail==email
tệp tin==tập tin==tệp==file
ghi==viết==viết ra==ghi ra==viết lại==ghi lại
chú giải==chú thích==nhận xét==bình chú==phụ chú==bị chú==chú dẫn
nhớ==trí nhớ==kí ức
nêu rõ==định rõ==chỉ rõ==nói rõ==ghi rõ==được định rõ==được chỉ rõ==được nói rõ==được ghi rõ
hợp==nhập==hợp nhất==thống nhất==sáp nhập==hợp vào==nhập vào
tổ ấm==mái ấm==gia đình
nam==nam giới==đàn ông==con trai
kỉ==kỷ==kỉ địa chất==kỷ địa chất==thời kì==thời kỳ
dối trá==điêu==điêu toa==nói dối==nói láo==xuyên tạc==sai sự thật
giao==trao==giao nhiệm vụ==giao việc
giao diện==giao diện người dùng
trao đổi==thảo luận==tranh luận==bàn luận==luận bàn==cuộc trao đổi==cuộc thảo luận==cuộc bàn luận==cuộc luận bàn==cuộc tranh luận
giao tiếp==tương tác==tác động qua lại==ảnh hưởng lẫn nhau
lớn==nhiều==vô tận==vô hạn==vô biên==bất tận==vô cùng==khổng lồ==to đùng==vĩ đại==kếch xù==không giới hạn==không điểm dừng==không bến bờ==không bờ bến
giá==trị giá==có giá==phải trả
giám đốc==người chỉ đạo
gián tiếp==không trực tiếp
đứt==ngắt==gián đoạn==đứt quãng==ngắt quãng==ngắt đoạn==đứt đoạn==cách đoạn==cách quãng
sách giáo khoa==sách giáo trình==giáo trình==sách
giảng viên==giáo viên==giảng viên đại học==giáo viên đại học
gió==như gió
mạo==giả==giả mạo==fake==làm giả
giải pháp==cách giải quyết
xử lí==xử trí==xem xét==giải quyết==đối phó
vui==hề==hài==ngộ==tếu==nhộn==sướng==mừng==hóm==vui vẻ==vui lòng==vui sướng==sướng vui==vui mừng==mừng rỡ==mừng vui==vui tươi==vui nhộn==dí dỏm==hóm hỉnh==tếu táo==hài hước==khôi hài==buồn cười==ngồ ngộ==ngộ nghĩnh==tức cười==nực cười
giải tích==vi tích phân
giấy==giấy in==folio
đạp==giẫm==dậm==giậm==đạp đổ==giẫm nát==dậm chân==giậm chân
giọng==sắc thái giọng
tiếng nói==giọng nói
thượng hạng==tuyệt đỉnh==đỉnh cao==số một==tuyệt hảo==đỉnh==hảo hạng==siêu hạng==tột đỉnh==tột bậc
giống==tựa==như==tương tự==tựa như==na ná
ngành==nghề==giới==lĩnh vực==lãnh vực
công khai==ra mắt==trình diện==trình làng==có mặt==xuất hiện==rõ ràng==không che giấu==ai cũng biết==không giữ kín==không giấu giếm
giờ giấc==giờ
để nguyên==giữ nguyên
đồng tính nam==pê đê==bê đê==gay==bóng==gây
hiếu chiến==hung hăng==gây hấn==gây gổ==hùng hổ==hay gây sự
khía cạnh==phương diện==góc cạnh
khiến==khiến cho==cho==mang cho==đem đến==đem lại==đem cho==mang lại cho==mang đến cho==đưa đến cho
ấn==nhấn==gí==đè==ấn xuống==nhấn xuống==gí xuống==đè xuống
khuôn mặt==gương mặt
gấp đôi==gấp hai==gấp hai lần==bằng hai lần
gần như==gần giống==gần với==giống với==kiểu như
gần đây==vừa qua==mới đây==vừa mới qua==mới qua==gần mới đây
gắn bó==keo sơn==keo sơn gắn bó==gắn bó keo sơn==đồng cam cộng khổ
gắng sức==gắng
lướt==trượt==sượt==thoáng==thoảng==lướt đi==trượt đi==sượt qua==thoáng qua==thoảng qua
gầm==rú==rống==kêu==hú==gầm lên==rú lên==gầm rú==gào rú
gốc==nguồn==nguồn gốc==căn nguyên==khởi nguyên==xuất xứ==nguồn cội==cội nguồn==khởi đầu==khởi thuỷ==nguyên uỷ
khổ==cực khổ==khốn khổ==khổ sở==đau khổ==khổ đau==đau đớn==khổ hạnh==bất hạnh==cùng khổ==khổ ải==khổ nhục
kép==ghép==phức==phức hợp==đa hợp==hồn hợp==hợp chất
rạng rỡ==rạng ngời==tươi tắn==tươi rói==hân hoan==háo hức==hào hứng==tươi roi rói
gỉ==rỉ==han==han gỉ==han rỉ
kém==không dai==không lâu==dễ quên==hay quên==chóng quên==nhanh quên==mau quên==quên trước quên sau
hen==hen suyễn==bệnh hen==bệnh suyễn==bệnh hen suyễn
hiếu khách==mến khách
tốt==tử tế==tốt bụng==hảo tâm==thiện tâm==nhân từ==thương người==tốt tính
hiển thị==hiện
ý thức==nhận thức==hiểu biết==sự ý thức==sự nhận thức==sự hiểu biết
thời nay==ngày nay==hiện thời==hiện tại==hiện nay==thời tại
ngày nay==hiện nay==thời nay
hiệu lực==có hiệu lực
bội thu==năng suất==hiệu quả==hiệu quả cao
Chủ tịch==hiệu trưởng==chủ toạ
văn chương==hoa mĩ==hoa mỹ
sợ==khiếp==sợ hãi==hoảng sợ==khiếp sợ==kinh hãi==kinh sợ==hãi kinh
thích hợp==phù hợp==hoà hợp==hoà hợp với==theo đúng với
ngờ==nghi==nghi ngờ==ngờ vực==nghi hoặc==hồ nghi==nghi vấn==mối nghi==mối ngờ==sự nghi ngờ==sự ngờ vực==sự nghi hoặc==sự hồ nghi==sự nghi vấn
xong xuôi==hoàn thành==hoàn tất==hoàn chỉnh==trọn vẹn==tròn vẹn==vẹn tròn
hoàn cảnh==tình cảnh==tình thế==tình trạng==trạng thái
hoàn hảo==không có sai sót==không có sai lầm==không mắc lỗi==không chê vào đâu được
trẻ==trẻ tuổi==thiếu niên==thanh niên==non nớt==chưa chín chắn==chưa trưởng thành
hoàn toàn==toàn bộ==triệt để==dứt khoát
hoãn lại==trì hoãn==tạm ngừng==hoãn
lạnh nhạt==lạnh lùng==lãnh đạm==lạnh lẽo==hờ hững==hững hờ==thờ ơ==giá băng==băng giá==lạnh như băng
đáp ứng==thoả mãn==làm tròn==đúng yêu cầu==làm thoả mãn==làm vừa lòng==làm hài lòng
ẩn ý==hàm ý==ngụ ý==hàm ẩn
hàng không==đường hàng không==bằng hàng không==bằng đường hàng không
thường==chuẩn==thông thường==bình thường==tiêu chuẩn
thực hiện==sự thực hiện==thi hành==sự thi hành==thực hành==sự thực hành==thực thi==sự thực thi
hình vẽ minh hoạ==hình minh hoạ==hình
dường như==có vẻ như==coi bộ==hình như==xem như
làm==làm thành==làm nên==làm ra==tạo ra==tạo thành==chế ra==chế thành==chế tạo==chế tạo ra
ngửi==hít==đánh hơi
hôm qua==ngày hôm qua
hướng về==tiến về==đi về==nhằm==nhắm==nhằm vào==nhắm vào==hướng vào==tiến vào
ửng==hường==hồng==ửng đỏ==ửng hồng==ửng lên==hường lên==hồng lên
hưởng==nếm==hưởng thụ==nếm trải
hạn==vận==hoạ==nạn==vận đen==vận hạn==tai ương==tai hoạ==tai ách
nhược điểm==điểm yếu==khuyết điểm==hạn chế==yếu điểm==chỗ yếu==chỗ kém==hạn chế
nghèo==khó khăn==nghèo khó==nghèo túng==túng thiếu==nghèo nàn
điều khoản==hạng mục
hấp dẫn==hút==có lực hút==có lực hấp dẫn
nhiều nhất==hầu hết==phần đông==đa số
hẹn==hẹn hò==mời đi chơi
hết==đã xong==đã kết thúc==đã hoàn thành
quá==quá thể==quá đỗi==quá chừng==hết sức==cực kì==rất==vô cùng
hệ thống số==hệ số
liên từ==hệ từ==động từ nối
thổi==xì==hỉ
tên họ==họ
người học==học sinh==học viên==sinh viên==học trò==trò
học tập==việc học==sự học
thăm==đến thăm==đi thăm==tới thăm==công du
hồ==hồ cứng
hồi==tràng
đáp lại==trả lời==đối đáp==đáp lại==hồi đáp==phản hồi==ứng đối==ứng đáp==đối đáp lại==trả lời lại==hồi đáp lại==phản hồi lại
bừa==bừa bãi==bát nháo==lung tung==nhao nhao==nhộn nhoạm==lôi thôi==mất trật tự==vô kỉ luật==không trật tự==bạ đâu vứt đấy
hội nghị==buổi họp==kì họp==kỳ họp==phiên họp
seminar==hội thảo==hội nghị chuyên đề
xúm quanh==đổ về==đổ dồn về==cùng kéo về==cùng đổ về==hội tụ==quy tụ==tụ lại
ban==uỷ ban==hội đồng==uỷ ban giám sát==hội đồng giám sát
mù mịt==tối tăm==bất định==vô định==rối==rối tắm==rối như tơ vò==không xác định==không rõ ràng==lờ mờ==mập mờ==mơ hồ
hợp đồng==bản thoả thuận==bản giao ước==biên bản thoả thuận==biên bản giao ước==bản giao kèo
hứa==hứa hẹn==hẹn ước==cam kết==giao ước
hứng==nứng==hứng tình==nứng tình
hứng thú==lí thú==lý thú
a hèm==e hèm==hèm hèm==hừ
đòi hỏi==yêu cầu==cần==bắt phải==đòi hỏi phải==cần phải có==phải==cần phải==cần có
phục vụ==có chức năng==thực hiện chức năng==có tác dụng==có vai trò
hữu hiệu==hiệu nghiệm==có hiệu nghiệm
im==ắng==lặng==lắng==im lặng==im ắng==im bặt
in==hằn==lằn==in hằn==in lên==hằn lên==lằn lên==in hằn lên
đào==đào bới==khai quật==khai phá==khoét==moi==khoét rỗng
khan==khô==khô hạn
gớm==tởm==ghê==kinh==gớm ghiếc==gớm guốc==ghê tởm==kinh khủng==kinh tởm==kin hồn==tởm lợm
khuyết tật==khiếm khuyết==tàn tật==mất khả năng==sự khiếm khuyết==sự mất khả năng
xui==khiến==bảo==xui khiến==thuyết phục
khiếu nại==đơn kiện
sức==khả năng==công suất==dung lượng==sức chứa
khoa học==thuộc về khoa học==thuộc về trí thức
sự ba hoa==sự khoác lác==sự phét lác==sự khoe khoang==ba hoa==khoác lác==phét lác==khoe khoang
khoá==điệu==khoá nhạc==âm điệu
khoản==mục
chặng==đoạn==quãng==chặng đường==đoạn đường==quãng đường==chặng đường đi==đoạn đường đi==quãng đường đi
quy mô==có quy mô==qui mô==có qui mô
khung tham chiếu==khung
khuyên==khuyên bảo==khuyên răn==khuyên nhủ
cảnh báo==khuyến cáo
cổ vũ==động viên==khích lệ==làm phấn chấn==làm phấn khởi==làm hưng phấn==làm hân hoan==làm hứng khởi
độc==riêng==độc nhất==độc đáo==riêng biệt==khác biệt==khu biệt==đặc biệt==đặc thù
khác nhau==không thống nhất==không nhất quán==trái ngược nhau
khác thường==lạ thường==dị thường==kì dị==kỳ dị==không thông thường
khách==khách hàng==người tiêu dùng==người mua hàng
vắng==thoáng==thoáng đãng==thoải mái==rộng rãi==thênh thang==không đông==không đông đúc
khán giả==người xem
hên==may==đỏ==vận may==vận hên==dịp may==vận đỏ==dịp hên==dịp son==vận son==cơ may
nhạy bén==nhạy cảm==tinh tế==tế nhị==tinh vi==khó thấy
khí==chất khí
khó==gian khổ==khổ cực==gian nan
khó ưa==gắt gỏng==cau có==khó chịu==khó tính==quạu quọ==nhăn nhó==cáu kỉnh
mờ ám==ám muội==bất minh==khuất tất==khó hiểu==không minh bạch==không phân minh==không rành mạch
khiếm nhã==thô tục==khó nghe==xúc phạm
khó đọc==không thể đọc được==không thể giải đoán được
lập lại==phục==phục hồi==khôi phục==phục nguyên==phục hưng
không==không có==không chút gì==không chút nào
không khí==bầu không khí
không lưu==giao thông hàng không
sai==lỗi==không chính xác==không tốt==không đúng
khả thi==có thể thực hành được==có thể thực hiện được==có thể làm được
kiện==tố==kiện cáo==tố tụng==khởi tố==truy tố==điều tra
cấp bách==cấp thiết==thúc bách==khẩn cấp==khẩn trương
khắc==xung==kị==xung khắc==tương khắc==khắc nhau==xung nhau==kị nhau==không tương thích==không thù hợp==không tương thích với nhau==không phù hợp với nhau==xung khắc nhau
khổ==khổ sở==khốn khổ==đau đớn==cực khổ
làm hoảng==làm hốt==làm khiếp sợ==làm kinh sợ==làm kinh hãi==làm kinh hoàng==làm hoảng sợ==làm hoảng hốt==làm hốt hoảng==làm mất vía==làm hết vía==làm hết hồn==làm sợ mất vía==làm sợ hết hồn==làm hết hồn hết vía==khủng bố tinh thần==khủng bố
kinh nghiệm==lão luyện==có kinh nghiệm==giàu kinh nghiệm==từng trải==trải đời
nâng chân vuông góc==ép chân vuông góc==kip==động tác kip
kiêu==tự phụ==tự mãn==kiêu ngạo==kiêu căng==ngạo mạn==kiêu kì==tự cuồng==vĩ cuồng==tự sướng==tự mê==sĩ diện==tự huyễn hoặc==tự cao tự đại
cuộn==xoay==quay==xoáy==cuộn tròn==xoay tròn==xoáy tròn==xoáy trôn ốc==xoắn ốc
kiến thức==học thức==học vấn==tri thức==vốn học==sở học
giám sát==quản lí==kiểm soát==cai quản==quản lý==trông nom==trông coi
soi==soi xét==thanh tra==kiểm định==kiểm nghiệm==nghiệm thu==sự soi==sự soi xét==sự thanh tra==sự kiểm định==sự kiểm nghiệm==sự nghiệm thu
kèm==theo kèm==kèm riết==kèm sát==theo sát
gối==chồng==lấp==chồng lấp==chồng lấn==chồng lên nhau==gối lên nhau==lấn lên nhau
đòi hỏi==yêu cầu==sự đòi hỏi==sự yêu cầu==việc đòi hỏi==việc yêu cầu
kí hiệu==bộ kí hiệu==ngôn ngữ đánh dấu
kí==ký==kí hợp đồng==ký hợp đồng==kí giao kèo==ký giao kèo==kí giao ước==kí giao ước==kí cam kết==ký cam kết
ngầm==mật==kín==bí mật==kín đáo
kính trọng==tôn kính==sự tôn trọng==sự tôn kính==lòng tôn tôn trọng==lòng tôn kính
kĩ thuật==kỹ thuật==có tính kí thuật==có tính kỹ thuật==mang tính kĩ thuật==mang tính kỹ thuật
kẻ==vạch==vẽ==dựng lên==vạch lên==vẽ lên
kẻ thù==kẻ địch==kẻ thù địch==quân địch
kế nghiệp==thừa kế==nối ngôi==kế vị==kế thừa==kế tục==nối nghiệp==kế nhiệm==đi theo==theo sau
kế toán==kế toán viên
kết luận==suy ra==luận ra==hiểu là
thành quả==kết quả==quả ngọt
kết thúc==làm xong==đi đến cùng==đi đến tận cùng==theo đuổi đến cùng==làm cho trót trét==tới bến
tuyên==kết án==định án==kết tội==định tội==phán quyết==tuyên án==tuyên phán==tuyên cáo có tội
kể==kể tên==kể ra==nêu==nêu ra==lên danh sách==lập danh sách==liệt kê
kĩ thuật viên==kỹ thuật viên
la==nốt la
lai==lai giống==ghép giống==cho lai giống==cho ghép giống
lang==khoang
làm==làm việc==lao động
nhanh==lẹ==mau==hoạt bát==linh hoạt==thoăn thoắt==lanh lẹ==mau lẹ==nhanh nhẹn
liên lạc==sự liên lạc==giao thông==sự giao thông
liên tục==liên tiếp==triền miên==liên miên==dai dẳng==dằng dài
liệt==tê liệt==bị liệt==bị tê liệt
bận tâm==suy tư==quan tâm==ưu tư==lo lắng==bận lòng==nhọc lòng==lo nghĩ==tư lự
run==lẩy bẩy==lật bật==bần bật==lập cập==run lên==run run==run rẩy==run sợ==run bần bật==run bây bẩy==run như cầy sấy
loài==thành viên
loại==bị loại==không chọn==không tuyển==không tuyển chọn==không được chọn==không được tuyển==không được tuyển chọn
ôn==luyện==ôn luyện==ôn tập==luyện thi==ôn thi
lí==lý==lí lẽ==lý lẽ==luận cứ
luận điểm==luận đề==chính đề
luật sư==thầy cãi==người biện hộ==người bào chữa
quấy rầy==phiền nhiễu==làm phiền==làm khó chịu==quấy nhiễu==trêu chọc==chọc tức==khiêu khích
phong tước==ban tước==làm chủ
làm đỡ==làm hộ==làm giúp
lặp lại==nhắc lại==nhại==nhại lại==bắt chước lại
phiền==làm phiền==quấy rầy==quấy rối==gây phiền phức==gây phiền hà==gây phiền toái==làm khó chịu==gây bất tiện
chào mừng==chào đón==đón chào==tiếp==tiếp đón==đón tiếp
vâng==nghe==vâng lời==vâng lệnh==nghe lời==nghe lệnh==tuân theo==tuân lệnh==phục tùng
lưu niên==lâu năm==sống lâu năm
lê==lết==kéo lê==lê lết==lê chân==lết chân==đi lê chân==đi lết chân
động lực tinh thần==động lực==động cơ==tác nhân
lí thuyết==lí luận
tim==trái tim==con tim==lòng
học thuyết==thuyết==giáo lí==niềm tin
lót==có lót
khi đó==lúc đó==thời gian đó==thời điểm đó==thời khắc đó==lúc đó==lúc bấy giờ==khi ấy==thời điểm ấy
tụt==rớt==thụt==tụt lại==thụt lại==tụt lùi==thụt lùi==giật lùi==tụt hậu==rớt lại==rớt lại đằng sau==lác
nhầm lẫn==lầm lẫn==sai sót==lầm lỡ==nhầm nhỡ==lộn==sự nhầm lẫn==sự lầm lẫn==sự sai sót
lờ==bơ==phớt==lơ==phớt lờ==phớt đi==bơ đi
lơ đãng==lơ đễnh==lơ là==sao lãng==sao nhãng==bỏ bê==thờ ơ==hờ hững
lượng==tầm lớn==độ lớn
mất tích==thất lạc==lạc
lan man==lạc đề
chen==len==chèn==lách==lấn==chen lấn
nhấn chìm==át==lấn át==lấn lướt
lấp==bịt==bít==lấp đầy==lấp kín==nhét đầy==nhét kín==bịt kín==bít kín
lấy lại==chiếm lại==giành lại==khôi phục lại==phục hồi lại==hồi phục lại
có được==lấy được==xin được
lập trường==quan điểm==thái độ==góc nhìn==cách nhìn==cách nhìn nhận
xáo==xào==trộn==xào xáo==đảo
để==ném==liệng==lẳng==vứt==hất==tống==nhét
lịch==lịch công tác
sử==lịch sử==sử sách==sử kí
lỗi thời==không hợp thời trang==không hợp mode==không hợp mốt==không hợp thời
to==bự==đồ sộ==to lớn==to bự==to kềnh==kềnh càng
hét==quát==la hét==quát tháo==hét lên==quát lên
tầng==lớp
lời==nhời==lời nói==nhời nói==lời lẽ==nhời nhẽ
lời khuyên==lời mách nước
lở==sạt lở==sự lở==sự sạt==sự sạt lở
lỡ==nhỡ
lợi==lợi ích==bổ ích
sở trưởng==ưu điểm==điểm mạnh==điểm tốt==điểm hơn==điểm tích cực==điểm trội==điểm vượt trội
uy==sang==uy nghi==uy nghiêm==trang nghiêm==tráng lệ==quý phái==sang trọng==hoa lệ
độc ác==hiểm ác==ác hiểm==nguy hiểm==đáng sợ==ma quỷ==quỷ sứ==quỷ quái
ngày mai==tương lai gần==tương lai không xa
gây ra==mang lại==cho ra==sinh ra==sản sinh
may mắn==diệu kì==thần kì==phép màu==phép mầu==nhiệm màu==nhiệm mầu
mẹ==má==bầm==u==mợ==me==mẫu thân
củng cố==sự củng cố==minh hoạ==sự minh hoạ
miền xác định==miền==tập xác định
thả==tha==giải phóng==thoát khỏi==phóng thích==cho tự do
mong muốn==ước mong==mong mỏi==ước ao==ao ước==sự mong muốn==sự ước mong==sự mong mỏi==sự ước ao==sự ao ước
mua==hối lộ==đút lót==mua chuộc==đút
cao su==trễ==muộn==trễ giờ==muộn giờ==không đúng giờ
màu==mầu==không trắng==da màu==da mầu==da không trắng==có da màu==có da mầu==có da không trắng
máy==như máy==giống như máy
đối==ngược==nghịch==đối lại==ngược lại==nghịch lại==đối nghịch==trái ngược==đối nhau==ngược nhau
mã lệnh==mã==mã máy tính
khung cảnh==môi trường
thứ năm==số năm==năm==hạng năm==cấp năm==bậc năm==hạng thứ năm==vị trí thứ năm
mơ hồ==mập mờ==nhập nhằng==nước đôi==nước hai==lưỡng nghĩa
mạng==mạng người==mạng sống==sinh mạng==sinh mệnh
nguy hiểm==nguy nan==hiểm nghèo==quái ác==nghiêm trọng==trầm trọng==nặng
mấu chốt==điểm mấu chốt
mật khẩu==mật ngữ==mật lệnh==khẩu lệnh==pass==password
mặc==phó mặc==để mặc
đo==định cỡ==tính==tính toán==đưa ra lời giải==đưa ra đáp án
mẻ==đợt==lô==ổ==lứa==lò
mềm==dẻo==mềm dẻo==đàn hồi==dễ uốn==dễ uốn cong
mốc==mốc meo==bị mốc==bị ẩm mốc
mối==mối hàng==mối làm ăn
mộng==giấc mơ==giấc mộng==ảo mộng==điều mơ tưởng==điều mơ ước
một lúc==một lát==một chốc==một chốc một lát
nhất quyết==quả quyết==khăng khăng==một mực==nhất mực
sơ bộ==mở đầu==bước đầu==dẫn nhập==chuẩn bị
chủ đích==chủ định==mục đích==ý định
sức mạnh==mức độ==quyền năng==năng quyền==quyền lực
nam==hướng nam==chính nam==hướng chính nam==S
túi bao==nang==bào xác
lập tức==tức thời==tức thì==ngay==trước mắt==ngay lập tức==ngay thức thời==ngay tức thì==ngay trước mắt
nghe==xử==xét xử
nghe được==nghe thấy==có thể nghe được==có thể nghe thấy
nghiêm túc==trang trọng
hồi tưởng==nghĩ lại==nhớ lại==ôn lại quá khứ==hồi tưởng lại==nhớ lại quá khứ
nghỉ==nghỉ ngơi==thư giãn==giải lao==sự nghỉ ngơi==thời gian nghỉ ngơi
nghỉ hè==nghỉ mát==đi nghỉ hè==đi nghỉ mát
nguy hiểm==nghiêm trọng
định luật==quy tắc==nguyên tắc==nguyên lí==nguyên lý
nguyên văn==nguyên bản
ngày nghỉ==ngày lễ==ngày nghỉ lễ==ngày lễ tết
ngôn ngữ==mang tính ngôn ngữ
người quen==người thân==người nhà==bà con thân thuộc
thị nữ==tì nữ==hầu gái==đầy tớ gái==bảo mẫu==người ở
ngược==ngược chiều==ngược lại
đột xuất==ngẫu nhiên==không chủ đích==không chủ ý==không định trước==không cố ý
ngắn==được cắt ngắn==bị cắt ngắn==được rút ngắn==được cưa ngắn==bị rút ngắn==bị cưa ngắn
nằm==ngồi==ì==ườn==ngồi ì==nằm ườn==ngồi ì ra==nằm ườn ra==chảy thây==chẩy thây
ngoại tình==lăng nhăng==gian dâm==thông dâm==chơi==ngủ
nhiễu==sự gây nhiễu
nhiệt tình==sự nhiệt tình==lòng nhiệt tình==sự hăng hái==lòng hăng hái==nhiệt huyết==sự nhiệt huyết==lòng nhiệt huyết==nhiệt tâm==sự nhiệt tâm==lòng nhiệt tâm
nhẹ==nhỏ==nho nhỏ
am tường==thuần thục==thành thục==nhuần nhuyễn
chính quyền==chính phủ==nhà nước==của chính quyền==của chính phủ==thuộc về nhà nước
thô==vô học==thất học==ít học==thô thiển==vô giáo dục==không được dạy dỗ==không được đào tạo
nhân==phép nhân
mềm mỏng==nhân nhượng==tốt nhịn==chịu nhịn==biết nhường nhịn==dĩ hoà vi quý
phần==thành phần==phần hợp thành==nhân tố==yếu tố
cảm thông==thông cảm==sẻ chia==đồng cảm==động lòng==thương cảm==trìu mến==nhân hậu
công chức==viên chức==nhân viên
nhân vật==nhân vật nổi tiếng==người nổi tiếng
nhìn==nhận==nhìn nhận==nhìn ra==nhận ra
nhóm trưởng==trưởng nhóm
bất biến==như cũ==y nguyên==không thay đổi==không biến đổi
vừa ý==hợp ý==như ý==thoả nguyện==mĩ mãn==thoả điều kiện==thoả mãn điều kiện
đổi==chuyển==ngả==đổi màu==đổi mầu==chuyển màu==chuyển mầu==ngả màu==ngả mầu
nhượng bộ==sự nhượng bộ==sự nhân nhượng
bịa==bịa đặt==thêm thắt==bốc phét==dựng đứng==thêu dệt==cường điệu==nói ngoa==nổ==chém==chém gió
nhảy==đệm==co bóp==khiêu vũ==đánh nhịp==gõ phách
thu lượm==thu nhặt==thu gom==góp nhặt==sưu tầm==sưu tập==tập trung
nhấp==đạp nhẹ
lầm lỡ==lỡ lầm==sai sót==sơ suất==nhầm lẫn==lầm lẫn
danh tính==danh tánh==sự nhận dạng==sự nhận diện==nhận dạng==nhận diện
nhòm==soi==quan sát==theo dõi
nhậu==nhậu nhẹt==chè chén==cuộc nhậu==cuộc nhậu nhẹt==cuộc chè chén==bữa nhậu==bữa nhậu nhẹt==bữa chè chén,
nhấc==nâng==giơ==đưa lên==nhấc lên==nâng lên==giơ lên
nhắc nhở==điều nhắc nhở
nhắn==nhắn tin==gửi tin nhắn==gửi tin==gởi tin nhắn==gửi tin nhắn==chuyển tin==gởi tin
nhẹ nhàng==êm ái==du dương
vần==nhịp==vần điệu==nhịp điệu==vần nhịp
hầm==ninh==nấu nhừ
niêm==đóng dấu niêm==đóng dâu niêm phong
no==trạng thái no nê
note==bản ghi==bản ghi chép==bản ghi chú
sút==đá==ném==ném vào==sút vào==đá vào
vẻ mặt==nét mặt==điệu bộ khuôn mặt==biểu hiện khuôn mặt==biểu cảm khuôn mặt
nêm==chèn nêm==chêm nêm==kê nêm==đóng nêm
nòi==nòi giống==giống nòi
nói==nói ra==tiết lộ==tiết lộ ra
cuộc nói chuyện==cuộc trò chuyện==cuộc chuyện trò==nói chuyện==trò chuyện==chuyện trò
nói lắp==cà lăm
nói thẳng==nói tuột==nói thẳng ra==nói tuột ra==nói tuột móng heo
nói đùa==nói giỡn==pha trò==đùa bỡn==vui đùa
hay cáu==nóng tính==dễ cáu==dễ nổi giận==nóng nảy==nóng vội==nóng==nóng tính==hay gắt
mọi==nông dân==hạ đẳng==hạ lưu==giống mèo mả gà đồng==cẩu tạp chủng==kẻ vô lại==kẻ khốn nạn
nông thôn==thôn dã==dân dã
nút==nút lại==nút vào
năm==5==v
năm mới==New_Years_Day==New_Years==January_1
năng khiếu==tài năng thiên phú==năng lực thiên phú==tài thiên bẩm==năng lực trời cho
năng lượng==sinh lực==khí lực
đủ điều kiện==đủ tiêu chuẩn==đủ khả năng==đủ tư cách==đủ năng lực==có đủ khả năng==có đủ tiêu chuẩn==có đủ điều kiện==có đủ năng lực
nước==dưới nước==thuỷ sinh
ngoại lai==nước ngoài==ngoại bang==thuộc nước ngoài==thuộc chủng tổng khác
nắm chắc==nắm vững==hiểu rõ
trôi==giạt==cuốn trôi==kéo trôi==trôi giạt==cuốn đi==trôi đi==giạt đi
lồi==đặc sắc==nổi bật==đáng chú ý==gây ấn tượng
nội địa==nội bộ
trung==vừa==trung bình==cỡ trung==ở giữa
phái nữ==nữ giới==phái yếu==phái đẹp==đàn bà
nữ giới==phái đẹp==phụ nữ
oi==oi bức==oi ả==nóng bức==nóng nực==ngột ngạt==khó thở==oi nồng
cái O.K.==cái OK==cái Okay==cái Ok==cái Okie==cái ok==cái okie==cái ôkê==O.K.==OK==Okay==Ok==Okie==ok==okie==ôkê
phai==lan==loang==phai ra==lan ra==loang ra
lao==phóng==phi==lao nhanh==lao như tên bắn==phóng nhanh==phi như bay
phim==phim ảnh==điện ảnh==phim điện ảnh
lượt==phiên==lần
phiên bản==biến thiên
phiên dịch==thông dịch==phiên dịch viên==người phiên dịch==thông dịch viên
gọi điện==điện thoại==điện==gọi điện thoại==phone
trao quyền==ban quyền==giao cho==ban cho==phong
văn phong==lối viết==cách viết==phong cách==phong cách viết==phong cách viết văn
thừa==dư thừa==dư==không cần thiết==thừa thãi==hơn mức bình thường==vượt mức cho phép
tục==lệ==tập tục==tập quán==tục lệ==phong tục
phun==phọt==làm phun ra==làm phọt ra==làm bắn ra
phá sản==vỡ nợ==bại sản==bị phá sản==bị vỡ nợ==bị bại sản==khuynh gia bại sản
soạn thảo==phác thảo==khởi thảo
chế tài==luật pháp==pháp luật
lộ==lộ ra==phơi bày==phát giác==phát hiện==phát lộ==khám phá==phanh phui
nảy sinh==nẩy sinh==phát sinh==nảy ra==nẩy ra==hiện ra
phân biệt==phân biệt được==biết phân biệt
phân phối==phân bố==phân bổ==phân tán
phân hạng==phân loại==sắp xếp thành loại==sự phân hạng==sự phân loại==sự sắp xếp thành loại
thử==xét nghiệm==phân tích==thí nghiệm==thể nghiệm==kiểm nghiệm==khảo nghiệm
khiển trách==quở trách==trách cứ==trách mắng==trách phạt==mắng mỏ==răn dạy==phê bình
hoang==phí==lãng phí==hoang phí==hoang toàng==phung phí
phòng==ngăn ngừa==phòng ngừa==dè chừng
quyên==quyên góp==đóng góp==cống hiến==hiến tặng==quyên trợ==quyên tặng==sự đóng góp==sự quyên góp==sự cống hiến==sự quyên trợ==sự quyên tặng==sự hiến tặng
hướng==phương==phương hướng
phương pháp luận==phương pháp học
phạm==vi phạm==sai phạm==xâm phạm==làm trái==lám sai==đi ngược
vừa phải==phải chăng==có mức độ==điều độ==ôn hoà==không quá khích
phản==làm phản==phản kháng==không vâng lời==không phục tùng==không tuân lệnh==không tuân theo==không chịu phục tùng==không chịu vâng lời==không chịu tuân theo
thể hiện rõ==biểu hiện rõ==cho thấy rõ==phản ánh
phản đối==không tán thành==gây bất lợi==gây cản trợ==gây trở ngại==gây tổn hại
phản xạ==phản ứng==phản tác dụng==đi ngược lại
phần mềm==chương trình phần mềm==phần mềm máy tính==hệ thống phần mềm==bộ phần mềm
phỏng vấn==cuộc phỏng vấn==bài phỏng vấn
điều chỉnh==chỉnh==chỉnh lí==bù==đền bù==bù đắp==bồi thường==làm ngang bằng
hợp tác==sự hợp tác==tham gia==sự tham gia
thuộc==lệ thuộc==phụ thuộc==mất tự do==không tự do==bị ràng buộc==bị hạn chế==bị kìm kẹp
phục vụ==phụng sự==phục dịch==chăm sóc==săn sóc
quan==quan lại
làm tình==quan hệ==ân ái==ái ân==sinh hoạt tình dục==quan hệ tình dục
hệ trọng==quan trọng==trọng yếu==có tính quyết định==mang tính quyết định
quang==thoáng==thoáng đãng==thông thoáng
quay==ghi hình==thu hình==quay phim
trở lại==quay lại==quay về==trở về==trở lại với==quay lại với==quay trở lại với==trở về với==quay về với
quen==quen mặt==được biết rõ==được hiểu rõ==nổi tiếng
thông thường==quen thuộc==thường lệ
quy==bắt phải chịu==đánh (thuế)
bắt lỗi==chụp lỗi==qui chụp==quy chụp
quyền==quyền lợi
cuốn==quyển==tập
thời gian tiếp diễn==thời gian diễn tiến==quá trình
quát==quát tháo==quát nạt
đẻ==sinh==sinh đẻ==sinh nở==sự đẻ==sự sinh==sự sinh nở==sự sinh đẻ==sự lâm bồn==sự sinh con
quên==quên đi==chôn vùi==lãng quên==quên lãng
yêu==thích==mến==chuộng==ưa==ưa chuộng==yêu mến==mến phục==mến mộ==hâm mộ==ngưỡng mộ
quả==nhân quả==quả báo==báo ứng==nghiệp báo
quỹ==quỹ tài trợ==quỹ bảo trợ
riêng==tư==riêng tư==cá nhân==đặc thù
run==run rẩy==run run
rung==rung chuyển==lay chuyển==rung lắc==chao đảo==làm rung chuyển==làm rung động==làm chấn động==làm lay chuyển==làm rung lắc==làm chao đảo
ràng==bó
rán==chiên
sáng==rực rỡ==sáng chói==sáng ngời==chói lọi==huy hoàng==lộng lẫy
xếp==chỉnh==sắp xếp==xếp hàng==xếp ngay ngắn==xếp thẳng hàng==chỉnh ngay ngắn==chỉnh thẳng hàng==sắp xếp hàng==sắp cho thẳng hàng
trượt==rớt==bị trượt==bị rớt==đánh trượt==hỏng thi==thi hỏng==không đỗ
nứt==rạn==nẻ==nứt nẻ==nứt rạn==rạn nứt==làm nứt==làm rạn==làm nẻ==làm nứt nẻ==làm nứt rạn==làm rạn nứt
rảnh==rỗi==rảnh rỗi==rảnh rang==rỗi rãi==ngồi không
rẻ==không đắt
rộng==rộng lùng thùng==rộng thùng thình==lùng nhùng
rời==li khai==riêng rẽ==chia rẽ==phân rẽ
mạo hiểm==rủi ro
là==ép==san==là phẳng==ép phẳng==san phẳng==làm phẳng==vuốt phẳng
tương lai==sắp tới==về sau==sau này==sẽ tới về sau
điên cuồng==cuồng điên==điên rồ==điên dại==rồ dại==cuồng loạn==sự điên cuồng==sự cuồng điên==sự điên rồ==sự điên dại==sự rồ dại==sự cuồng loạn
so sánh==đối chiếu==sự so sánh==sự đối chiếu
so le==xen kẽ==mọc so le==mọc xen kẽ
soi mói==xoi bói==xói móc==nhúng mũi==chõ mũi==tọc mạch==gí mũi==chõ mõm
viết==soạn==sáng tác==sáng tạo
suy==suy thoái==khủng hoảng==sa sút==sút kém
suy nghĩ lại==xem xét lại==cân nhắc lại==suy xétlại
phẳng==bằng==thẳng==bằng phẳng==thẳng thớm
suông==chay==không đệm==không nhạc==không nhạc đệm
giần==sàng==rây
thấp==thấp giọng==khẽ==khe khẽ==rì rầm==thì thầm==thỏ thẻ==thì thào
huyền bí==sâu xa==uyên thâm==thâm thuý==huyền viễn==thâm sâu
sóng==chuyển động sóng==chuyển động dạng sóng
sôi động==sinh động
giũ==giặt==dội==súc==sục==rửa
súc tích==hàm súc
săn==săn mồi==tìm mồi==kiếm mồi==tìm thức ăn==kiếm thức ăn==tìm kiếm thức ăn
sản==khoa sản==phụ sản==khoa phụ sản==sản khoa
sản xuất==sản xuất ra==sản xuất công nghiệp
sắc==nhọn==bén==sắc bén
xếp==chỉnh==sắp xếp==xếp hàng==xếp ngay ngắn==xếp thẳng hàng==chỉnh ngay ngắn==chỉnh thẳng hàng==sắp xếp hàng==sắp cho thẳng hàng
dọn==dọn dẹp==cất dọn==thu dọn==sắp xếp==bài trí==bày biện
hữu hình==tồn tại==hữu tồn==sự hữu hình==sự tồn tại==sự hữu tồn==sự sống
số liệu==con số thống kê
sản lượng==số lượng
trọ==ở==sống==cư trú==cư ngụ==tạm trú==thuê trọ==ngụ cư
sổ==sổ ghi chép==sổ tay
tiếc==hối==hối tiếc==tiếc nuối==nuối tiếc==ân hận==ái ngại
sủa==cắn
ăn==chén==đớp==hốc==măm==ngốn==tọng==xơi==xực==dùng==dùng bữa
biên tập==sửa lại==duyệt lại
sự cố==sự cố treo máy
lễ==buổi lễ; dịp==sự kiện
sự nghiệp==công danh==công danh sự nghiệp
sự thật==sự thực==thực tế==thực tại==thực tiễn
tang==hàm tang==tỉ số lượng giác tang==hàm số lượng giác tang==tg==tan
đầu gấu==tay chân==côn đồ==du côn==tên đầu gấu==tên côn đồ==tên du côn
tham gia==tham dự==gia nhập
thon==thanh==thon thả==mảnh mai==thanh mảnh
thanh thiếu niên==người tuổi teen==xì tin==ô mai==teen
làm thủ công==làm bằng tay==thao tác==thao tác thủ công==thao tác bằng tay
đại diện==thay mặt==làm phát ngôn viên
thế==thế chỗ==thay thế==thay chỗ==hất cẳng
vắng==thiếu==vắng mặt==sự vắng==sự thiếu==sự vắng mặt
lỗ hổng==thiếu sót
thiện chí==thiện ý==có thiện chí==có thiện ý
bất lợi==thiệt thòi==không thuận lợi
không gặp phải==không vướng phải==không đụng phải==tránh được==tránh khỏi==thoát==thoát được
thoại==lời thoại==hội thoại==đối thoại==cuộc đối thoại==lời đối thoại==mẩu đối thoại
thoả thuận==đạt được thoả thuận==đi đến thoả thuận==đi đến sự đồng ý
thu nhỏ==thu hẹp==thu ngắn
thua==bại==thua trận==bại trận==bị thất bại==bị đánh bại
nhà diễn thuyết==thuyết trình viên==người diễn thuyết
thuận==tương đương==tương đồng==tỉ lệ thuận
rất phát triển==thuận lợi==hưng thịnh==phất==có lời==có lãi
tiện lợi==thuận tiện==dễ dùng
thịnh vượng==phát đạt==phồn vinh==thành công==thanh bình==êm ả==vàng son
thành kiến==có thành kiến==biểu lộ thành kiến==phân biệt đối xử==không vô tư==không khách quan==không công bằng
thử thách==sự thử thách==thách thức==sự thách thức
thái==lạng==cắt lát==thái lắt==thái mỏng==cắt mỏng==lạng mỏng
tháng==tháng dương lịch==tháng lịch biểu
thích==chuộng==yêu==khoái==ưa==ưa chuộng
thính giả==người nghe
thông lệ==thói quen==lệ thường
thông dụng==phổ thông
tham số==tham biến==thông số
tuy-ô==nguồn tin==thông tin
hận thù==hận==thù==căm hận
thăm==ghé thăm
bưu phẩm==bưu kiện==thư==thư từ
thương==thương số
thương hiệu==tên thương mại==nhãn hiệu
thương lượng==thương thảo==dàn xếp==cuộc thương lượng==cuộc thương thảo==cuộc dàn xếp
sự buôn bán==thương mại==thương nghiệp==buôn bán
thang độ==thang đo==thước đo==thang đánh giá==khung đánh giá==thước đánh giá
hàng ngày==mỗi ngày==thường ngày==thường nhật
thưởng==ban thưởng==tặng thưởng==khen thưởng==thưởng công==ân thưởng
thất bại==không thành công
thất nghiệp==vô công rồi nghề==không nghề nghiệp
chán nản==nản lòng==buồn phiền==buồn lòng==phiền muộn==nản chí==thất vọng==ngã lòng==sầu não==thoái chí==mất tinh thần
phanh==phanh lại==thắng==hãm phanh==thắng phanh
thẻ==thẻ cá nhân==thẻ thành viên
thể==thức==thể thức==hệ thống giác quan==hệ giác quan
thể chất==thể trạng==tình trạng thể chất==tình trạng cơ thể==điều kiện thể chất
ả==thị
thống kê==ngành thống kê==khoa học thống kê
thời gian==thì giờ==thời giờ
người đứng đầu==thủ lĩnh==thủ lãnh
thủ thuật==sự nhanh tay
gian xảo==quay quắc==thủ đoạn==gian trá==gian xảo==không thành thật==không thật thà==không trung thực
thứ bảy==thứ 7==ngày thứ bảy==ngày thứ 7
nhì==thứ hai==thứ nhì==đệ nhị
trật tự==thứ tự==ngăn nắp==có trật tự==có thứ tự
thừa==lặp==lặp từ==thừa từ==lặp ý==thừa lời
bản chất==thực chất==bên trong
tin học==khoa học máy tính==khoa học điện toán
yếu==yếu ớt==mong manh==mong manh dễ vỡ
tinh thần==tâm hồn==linh hồn
tiu==bạt
tiên==thần tiên
tiêu cực==có chiều hướng tiêu cực==mang tính tiêu cực==có tính chất tiêu cực
diễn tiến==diễn biến==tiến triển==xảy ra==diễn ra==trôi qua==tiến trình==tiến độ
tiến bộ==tiên tiến==cấp tiến==hiện đại
đẩy mạnh==tăng cường==tăng tốc==thúc đẩy==xúc tiến==leo thang==tăng tốc độ
tiếng ồn==tiếng ồn ào
tiếp cận==tới gần==đến gần==sự tiếp cận==sự đến gần==sự tới gần
tiếp diễn==thì tiếp diễn==thời tiếp diễn,
lưu trú==ở lại==việc ở lại==việc nghỉ lại
tiếp xúc==va chạm==sự va chạm==sự tiếp xúc
kiêng==kiêng cữ==kiêng khem==tiết chế==ăn kiêng
tiết kiệm==hà tiện==sẻn==dè==dè sẻn==sẻn so==tùng tiệm==tần tiện==tằn tiện==tiện tặn==hà tằn hà tiện==thắt lưng buộc bụng==bóp mồm bóp miệng
tiềm ẩn==tiềm tàng==tiềm năng
trước==phía trước==về phía trước==ở phía trước==tiến lên==tiến về phía trước
toàn diện==toàn phần
toán==toán học
trang==giai đoạn
tô điểm==trang hoàng==trang điểm==trang trí==làm đẹp
triệu==triệu hồi==triệu về==gọi về==mời về
trung==trung bình==bậc trung
yêu nước==ái quốc==trung thành==trung nghĩa==trung kiên
truyền đạt==truyền tải==truyền tin
trách nhiệm==nghĩa vụ==trách nhiệm pháp lí==nghĩa vụ pháp lí
trái==bên trái==cánh tả
tráng==tráng men==làm láng
trốn==tránh==né==trốn tránh==né tránh==lẩn tránh==lảng tránh==lẩn trốn==tránh khéo
trình==trình lên==đệ trình==đệ trình lên
công diễn==trình diễn==biểu diễn
trí óc==trí tuệ==trí não==đầu óc==tâm trí==tâm não==tâm tưởng
trò chơi==trò tiêu khiển==trò giải trí
sưng to==trương==sưng phồng==trương phồng==sưng to lên==sưng phồng lên==trương phồng lên
trường==trường thông tin
trường học==học đường==học hiệu
trải nghiệm==sự trải nghiệm
trấn an==làm yên lòng==làm cho yên lòng
trầm==nam trầm
trần==trần trụi==trần truồng==khoả thân==thoát y
trống==rỗng==trống rỗng==trống không==để trống==bỏ trống
điểm chính==điểm then chốt==trọng điểm
trồng==giồng
trội==nổi trội==có thế hơn==có ưu thế
rào cản==chướng ngại==vật cản==trở ngại==chướng ngại vật==rào chắn
trở thành==trở nên==biến thành==đổi thành==chuyển thành==hoá thành
tài trợ==cấp tiền==chu cấp==trợ cấp
gặp bất lợi==gặp trắc trở==gặp trục trặc==gặp sự cố==gặp chuyện==bị trục trặc==trục trặc==bị cản trở==bị ngăn cản==gặp khó khăn==đối mặt khó khăn
trừ==khấu trừ==trừ bớt==giảm thiểu
tu==ở tu viện
đen==mun==thâm==ô==ác==mực==huyền==tuyền
tuyển mộ==chiêu mộ==tuyển dụng
tuần==tuần lễ
tuổi thọ==tuổi==thời gian sử dụng
gây hại==tai hại==có hại==tác hại
ẩn dật==tách biệt==hẻo lánh==khuất nẻo==cô lập
tán==ve vãn==tán tỉnh==chim chuột==giở trò chim chuột==giở trò ong bướm==giở thói trăng hoa
tán dương==ca tụng==tán tụng==tôn vinh
dễ cảm==đa cảm==đa sầu đa cảm==tình cảm==tâm lí==tâm lý
tâm trạng==tâm sinh lí
tên==tên chính
truy tìm==săn lùng==truy lùng==tìm kiếm==cuộc truy tìm==cuộc săn lùng==cuộc truy lùng==cuộc tìm kiếm
tìm ra==dò ra==tìm thấy==phát hiện ra==khám phá ra
bối cảnh==tình hình==bức tranh
tích cực==theo chiều hướng tích cực==có tính tích cực==có tính chất tích cực
tích luỹ==tích góp==gây dựng
đặc tính==đặc trưng==đặc điểm==điểm đặc biệt
đại cương==tổng quan==trích yếu==khái lược==tóm lược==bản khái lược==bản tóm lược
tăng==lên==tăng lên==leo thang
tăng cường==làm tăng cao lên
nâng giá==tăng giá==tăng giá trị
tơi==xốp==tơi xốp
tư thế==cử chỉ==điệu bộ
ý tưởng==tư tưởng==lí tưởng
tư vấn==nhà tư vấn==người tư vấn
tương đối==kha khá
tại chỗ==ở tại chỗ==ở nguyên tại chỗ==ở nguyên vị trí
đương chức==đương nhiệm==tại chức==đương kim
tạm==tạm thời==tạm bợ
chở==đèo==đưa==mang==vác đi==đưa đi==mang đi==khuân đi==bê đi==chở đi==đèo đi==vận tải==vận chuyển
bạo hành==hành hung==tấn công==vụ bạo hành==vụ hành hung==vụ tấn công==cuộc tấn công
phạm vi==mức==tầm
sắt son==son sắt==tận tâm==tận tình==toàn tâm==toàn ý==toàn tâm toàn ý==một lòng một dạ
tập thể==đoàn thể
tập đoàn==corp==doanh nghiệp trách nhiệm hữu hạn
ứ==tắc==tắc ứ==dồn ứ==ngưng ứ==sự tắc ứ==sự ngưng ứ
tắt==ngừng hoạt động
tết==bện==tết lại==bện lại
tỉ lệ==tỷ lệ==tỉ số==tỷ số
tỉnh==tỉnh táo==sự tỉnh táo
ăn==chén==đớp==hốc==măm==ngốn==tọng==xơi==xực
ra vẻ==tỏ vẻ
chất==tư chất==tố chất
tốc độ==vận tốc
tối thiểu==rất thấp==rất nhỏ
tối ưu==tốt nhất
tốt nghiệp==ra trường==tốt nghiệp đại học==tốt nghiệp cử nhân==tốt nghiệp bậc đại học
tốt đẹp==hay ho==đáng tự hào
bị thương==tổn thương==chấn thương==thương tổn==bị tổn thương==bị chấn thương==bị thương tổn
tổng thể==tổng số==tổng cộng
tổng hợp==tổng hợp tính
bực==tức==bực tức==bực mình==tức tối==bức bối==tức giận
từ chối==từ bỏ==từ khước==chối từ==khước từ==sự từ chối==sự từ bỏ==sự từ khước==sự chối từ==sự khước từ
dần dần==từ từ==từng bước một
tự chủ==độc lập==tự do==sự độc lập==sự tự chủ==nền độc lập
mặc cảm==tự ti==mặc cảm tự ti==sự mặc cảm==sự tự ti==nỗi mặc cảm tự ti
tự tin==sự tự tin==lòng tự tin
tuỳ tiện==tuỳ hứng==tuỳ ý==tự ý
từ điển==tự điển
doạ==doạ nạt==doạ dẫm==đe nẹt==thị uy==uy hiếp==làm cho sợ hãi==làm cho kinh sợ==làm cho khiếp sợ
uy tín==thanh thế==uy thế==danh tiếng
đâm==trồi==đâm ra==trồi ra==nảy mầm==đâm chồi==mọc mầm
xin==van==nài==cầu xin==khẩn cầu==van xin==van nài==nài xin==nài van==khẩn cầu==van lơn
vay==vay vốn==mượn vốn
sáu==6==vi
viết tay==việc viết tay==viết lách
thớ==vân==thớ vật liệu==vân vật liệu
vè==bài vè
ví dụ==thí dụ
ẩu==vô ý==bất cẩn==cẩu thả==vô tình==thiếu suy nghĩ==thiếu cẩn trọng==thiếu cẩn thận==thiếu cân nhắc
văn==văn học==ngành văn==ngành văn học
vương==rải==vãi==vương vãi==rải rác==không được gom==không được tập hợp==không được gom lại
vượt==vượt lên==vượt lên trên==vượt lên trước
vượt quá==đi quá==đi quá xa==vượt quá xa
vật==đấu vật==đánh vật==vật nhau
cụ==vị
tiếng vỗ tay==cái vỗ tay==tràng pháo tay==việc vỗ tay==sự vỗ tay==vỗ tay
màu xanh lục==xanh lục==mầu xanh lục==xanh==màu xanh lá cây==mầu xanh lá cây==xanh lá cây
xem thường==coi thường==khinh thường==xem nhẹ==khinh miệt==miệt thị==bất kính==vô lễ
xin lỗi==cáo lỗi==tạ lỗi
quay quanh==xoay quanh
chiều hướng==xu hướng==trào lưu==xu thế
xung đột==mâu thuẫn==đối lập==sự xung đột==sự đối lập==sự mâu thuẫn
xuân==mùa xuân==vào mùa xuân
xuất==xuất khẩu==xuất cảnh==xuất cảng
xuống==xuống xe==xuống xe xuống ngựa==xuống xe xuống cộ==việc xuống==việc xuống xe==việc xuống xe xuống ngựa==việc xuống xe xuống cộ
xót==đau xót==rát==nhức
yêu thích==ưa thích==sự yêu thích==sự ưa thích==sự thích thú==sự ưa chuộng
yếu==yếu ớt==mỏng manh
ánh sáng==sự sáng
áo==tấm áo==chiếc áo
trừng phạt==áp bức==bóc lột==làm đau khổ
ứng dụng==sự ứng dụng==áp dụng==sự áp dụng==việc ứng dụng==việc áp dụng
sức ép==áp lực
âm==có âm==có thang âm==có âm chủ
âm lịch==lịch âm==lịch mặt trăng
tiếng động==âm thanh
bắt buộc==ép buộc==cưỡng bức==cưỡng chế
không cởi mở==ít nói==trầm lặng
nhỏ bé==bé bỏng==ít tuổi==bé nhỏ==bé thơ
ý muốn==ước muốn==nguyện vọng==ước vọng==sự mong==sự muốn==lòng ước mong==lòng mong mỏi==lòng mong muốn==lòng ao ước==lòng thèm muốn
ăn mặc==ăn vận
đa dạng==phong phú==nhiều dạng
gắn với==đi kèm==đi theo==đi cùng==hộ tống
được mướn==được thuê==đi làm==được thuê làm==được mướn làm==được tuyển dụng==được thuê làm việc==được mướn làm việc
đi lại==qua lại==đi lại thường xuyên==qua lại thường xuyên==qua lại giữa hai nơi==đi lại giữa hai nơi
đi qua==đi ngang qua==chạy ngang qua==chạy qua==chạy cắt ngang qua==đi cắt ngang qua
điên==điên cuồng==cuồng điên==điên rồ==mất trí==quẫn trí
sự chỉnh==điều chỉnh==điều tiết==sự điều chỉnh==sự điều tiết==sự sửa đổi
điều động==huy động==điều động quân lực==điều động binh lực==điều động quân đội==huy động quân lực==huy động binh lực==huy động quân đội
điểm==mặt==nét
đuôi==đít==phía đuôi==phía đít==phần đuôi==phần đít==ở phía đuôi==ở phần đuôi
đờm==đàm==có đờm==có đàm
đàn==bầy==bầy đàn
đào==bới==sự đào==sự bới==sự xới==sự cuốc==sự đào bới==sự đào đất
lễ cưới==lễ kết hôn==lễ vu quy==đám cưới==đám hỉ==hỉ sự==hôn lễ
đám đông==chen chúc==đám đông xô đẩy==đám đông chen chúc
đáng kể==khá nhiều
đánh dấu==làm dấu==đánh dấu chấm==làm dấu chấm
đánh máy==đánh máy tính
bảng đáp án==đáp án
đêm==buổi đêm
đình công==bãi công==cuộc đình công==cuộc bãi công==sự đình công==sự bãi công
đòi==lĩnh==yêu sách
đói==khát==thèm khát==thèm muốn==khao khát
đóng góp==góp phần==sự đóng góp==sự góp phần
cặp==đôi==cặp đôi==bộ đôi
đông==phía đông==hướng đông==ở hướng đông==ở phía đông==về hướng đông==từ hướng đông
phát sóng==đăng==đăng bài==phát==lên sóng
album==anbum==an-bum==anbom==đĩa==đĩa nhạc
đơ==đờ==đừ==chết lặng==đơ ra==đờ ra==đừ ra
đơn==đơn nhất==duy nhất
trơn==mộc mạc==giản dị==đơn giản
đơn hàng==đơn đặt hàng,
đơn vị quân đội==đơn vị quốc phòng==đơn vị
trình ra==mang ra==đưa ra==giơ ra==trưng ra
cho phép==cho phép==nhận vào==đưa vào==cho vào
đường==ngọt==có đường==có rắc đường==có cho đường==bọc đường
đường dẫn==cookie
đại số==đại số học
đạo==ăn cắp==ăn cắp ý==trộm ý tưởng==ăn cắp ý tưởng
đạo đức==đạo lí==đạo lý==đạo nghĩa==quy tắc đạo đức==nguyên tắc đạo đức==chuẩn mực đạo đức
đảm nhiệm==đảm nhận==đảm trách==gánh vác==nhận làm==tìm cách giải quyết
đầu tư==rót vốn==bỏ vốn==đầu tư vốn==sự đầu tư==sự rót vốn==sự bỏ vốn==sự đầu tư vốn
đầy==còn đầy==còn nguyên==chưa đụng đến==chưa sờ đến==chưa mó đến
đầy đủ==đủ đầy==sung túc==khá giàu==có của ăn của để
đậu==đỗ==đậu xuống==đỗ xuống==đỗ lại
điển hình==đặc trưng
đặt hàng==đặt mua
gọi tên==định danh==đặt tên
đẹp==duyên dáng==yêu kiều
đến==đạt tới==đi tới==đạt đến==đến mức==đạt mức
đề cập==sự đề cập==sự kể ra==sự nói đến
đề xuất==đề nghị==sự đề xuất==sự đề nghị==lời đề xuất==lời đề nghị
đền==bù==bồi thường==bồi hoàn==đền bù
legato==liền mạch==đều đều
chỉ định==để cho==dành cho
bỏ không==để không==không được bảo vệ==không được bảo hộ==không được che chở
đỉnh==có đỉnh==có đỉnh nhọn==có chóp nhọn==có mũi nhọn
địa chỉ==nơi đến==nơi nhận==địa chỉ người nhận==địa chỉ nơi nhận
địa lí==địa lý==địa lí học==địa lý học==ngành địa lí==ngành địa lí==khoa địa lí==khoa địa lý==môn địa lí==môn địa lý
địa phương==mang tính địa phương
đối thủ==địch thủ==người đối địch==người đối đầu==người chống đối==người phản đối
định hình==định dạng
định hướng==có định hướng==được định hướng
định kì==thường kì==định kỳ==thường kỳ==tuần hoàn==chu kì==chu kỳ
định nghĩa==lời định nghĩa==sự định nghĩa
đối tác==người hợp tác==người cộng tác==partner
đối tượng==chủ thể
cư xử==đối xử==hành xử==đối đãi==ăn ở
đồng nhất==đồng dạng==đồng bộ==giống nhau
đồng nghiệp==bạn đồng nghiệp==đồng ngành==bạn đồng ngành
đổi==đổi tiền==đổi tiền lẻ==đổi tiền thối
chiều cao==độ cao
khoảng cách==cự li==cự ly==độ dài==chiều dài
đội==đội quân==đội lính
thế hệ==đời
lẽ sống==đời sống==cuộc sống
chống==đỡ==chống đỡ
đủ==đủ ăn==đủ sống==giật gấu vá vai==giật đầu cá vá đầu tôm==vắt mũi đút miệng
đủ khả năng==đủ điều kiện==đủ tư cách==đủ tiêu chuẩn
đứng lên==đứng dậy==đứng thẳng dậy==bật dậy==đứng bật dậy
ấm==ấm dần==ấm dần lên==ấm lên==ấm hơn==ấm hơn lên
ấp úng==ngắc ngứ==ngập ngừng==nói ấm ớ==nói ấp úng==ấp a ấp úng==lúng búng==nói ấp a ấp úng==nói lúng búng==nói ngắc ngứ
ầm==ầm ĩ==rầm rĩ==huyên náo==náo động==om sòm==ỏm tỏi==um sùm==vô tổ chức
ồn==ồn ã==ồn ào==ra rả==ri ri
sự ớn lạnh==sự rùng mình==sự gai người==ớn==ớn lạnh==rùng mình==gai người==cảm giác ớn lạnh==nổi da gà
bênh==binh==ủng hộ==bênh vực
ứng==tương ứng==ngang nhau
